NO ./textures/AnyConv.com__Bricks_22-512x512.xpm
SO ./textures/deepslate_copper_ore.xpm
WE ./textures/deepslate_diamond_ore.xpm
EA ./textures/deepslate_emerald_ore.xpm

F 0,0,0
C 0,0,0

11111111111
10000000001
10000N00001
10000000001
11111111111
