111111111111
100000000001
1000000000011
10000000000001
10000000000001
1111111111111
