11111111111111111111111111111111111
10010000000000000000000000000000001
10010000000000000000000000000000001
100100N0000000000000000000000000001
11111100000000000000000000000000001
11111111111111111111111111111111111
