11111111111111
11110000001111
11110000001111
111100N0001111
11111100111111
11111100111111
11111101111111
     101111111
     101
     111
