111111111111
1100111000011
10001 100001
10001110011111
10000000000001
10000000000011
1111110111111111
     101
     101
     101
     111

